|--------|
|...|..-.|
|...|.@..|
|......-.|
|--------|